10 20
|------------------|
|F................P|
|F......|------|...|
|....|..|P.....|P..|
|....|..|......|...|
|....|.............|
|....|.........|...|
|....|----..---|...|
|...P|.@..P....|P..|
|------------------|